11111111111111111111111111111111
10000000000000000000w00000N00001
10000000000000000000000000000001
10000000000000000000001110w00001
100000000011111110000w0000000001
10000000000000000000000000000001
10011110000000000000011110000001
10000000000000P00000000000000001
10000000000001111110000000001111
10000000000000000010000000000001
10000000000000000010000011100001
10000000000000000011000000000001
1000000000000000000000000b000001
10000000000000000000000000000001
10000000000000000000001110000001
10000000000000000000000000000001
10000000000000000000000000000001
10000000000000000000000000111111
10000000000000000000011100000001
10000000000000000000000000000001
10000000000000001110000000000001
10000000000011100000000000000001
1P000000111100000000000000000001
11111111111111111111111111111111